NO ./texture/chest.xpm
SO ./texture/crafting_table.xpm
EA ./texture/bookshelf.xpm
WE ./texture/furnace.xpm

C 63,222,200
F 164,116,24

111111111111111111111111111111111111111111111
1N0000000000000000000000000000000000000000001
111111111111111111111111111111111111111111111
