NO ./texture/wall3.xpm
SO ./texture/wall1.xpm
EA ./texture/wall2.xpm
WE ./texture/wall3.xpm
WE ./texture/wall3.xpm

C 63,11,111
F 164,116,24

        1111111111111111111111111
        1000000000110000000000001
        101100000111000N000000001
        1001000000000000000000001
111111111011000001110000000000001
100000000011000001110111111111111
11110111111111011100000010001
11110111111111011101010011001
11000000110101011100000011001
10000000000000001100000000001
10000000000000001101010010001
11000001110101011111011110001
11110111 1110101 101111010001
11111111 1111111 111111111111